xxxxxxxxxxxxxxxx
x sx v  sx    vx
x  x   x   xx  x
x  v   xx  xxx x
x    x  x    xsx
x  xxxv xxx  xxx
x  xs   xv     x
x  x  xxxx  xxxx
x  xv   sx     x
x  xxxx  xxx vxx
x         px  fx
xxxxxxxxxxxxxxxx
